v_#_#_#_#_#_#_#_v_#_#_#_#_#_#_#_v_#_#_#_#_#_#_#_#_#_#_#_#_#_#_#_v_#_#_#_#_#_#_#_#_v_#_#_#_#_#_#_#_#_#
#_v_v_v___v___v_v___________v_____v_________________________v___v_v_v_v___________v_________________#
#___v_v_______v_v_____v_______v_____________________________v_____v_______________v_v_______________#
#___v___v_v_________________v_____v___________________________v_v___v_________v_____________________#
v_____v_v_v___v_____v_______v_v_______________________________v___v___v___________v___v_v_v_________#
#_v_______________v_____v___v_________________________________________________________v_v_v_v_______#
#_____v_______v___v_v_v_v_v_______v_____________________________v_________________v_v___v_v_v_v_____#
#_______________v_v_v_v_v_v_v___v___v___________________________________v___v_v_v___v_v_v_v_______v_#
#_____v_____v_v_v_v_v_v_v_v_v_v_v_________________________________________________v_____v_v_v_v_____v
#___________v___v_v_v_v_v_v_v_v___v___________________________________v_____v_____v___v___#___v_____#
#___v_____v_____v_v_v_v_v_v_v_v_v_v_________________________________________________v_____#_v_____v_#
v___________v_v___v_v_v_v_v_v_v_v_____v___v___________________________#####################_____v___#
#_____v_________v___v___v___v_v_v_v___________________________________________v___v_v_v_v_#_v_______#
#_____v___v_v_v_v___v_v_v_v_v_v_v_____v_________________________________________v_v___v___#___v___v_v
v___v___v_v_v_v_v_v_v_v_v_v_v_v_v_v_____________________________________________v_v___v_v_#___v_v___#
v___v___v_v___v_v_____v___v___v_v_v_v_________________________________________________v___#___v_____#
#___v_v_v_v_v_v_v_v_v_v___v_v_v___v_________________________________________________v_v_v_v_v_______#
#_____v_v_v_____v_v_v_v_v_v_v___v_________________________________________________________v_________#
#_v_v_v_v_v_v_v___v___v_v_v___v_v_________v_________________________________________________________#
#_v_v_v___###################___________________________________________________________________v___#
#___v_v_v_v_v_v_v___________________________________________________________________________________#
#_v_v_v_v_v_v_v___v_________________________________________________________________________________#
#_____v_v_v___v_v___v_______v___v_______________________v___________________________________________#
#___v_v_v_v_v_v___v_________v_______________________________________________________________________#
#_______v_v_v_______________________________________________________________________________________#
#___________v_____v_______________________v_______v_______v_________________________________________#
#_____v_________v___________________________v_________________v_____v_______________________________#
v___v_________________________________v_v___v_v___v_v_______v_______________________________________#
#_________________________________________v_v_v_v___v_v___v_______v_________________________________#
#_______________________________v_______v_v_v_v_v_v_v_v___v_v_#_#___________________________________#
#_____________________________________v_v_v_v_v_v___v_v_v_v_v_#_#___________________________________#
#___________________________v_____v_____v_v_v_v___v_v_v_v_v_v_#_#_____v_____________________________#
#_______________________________v_________v_v_v_v_v_v_v_v_v_v_###_v_________________________________#
#___v___________________________v_____v___v_v_v_v_v_v_v___v_v_#_#_________________________v_________#
#___________________________________v_____v_v_v_v_v_v_v_v_v_v_#_#_v_v_v_____________________________#
#_________________________v_____v_____v___v_v_v_v_v_v_v_v_v_v_#_#_v_______v_________________________#
v_v___________________________v_______v_v_v_v_v_v_v_v_v_v_v_v_###_v_v_______________________v_v_____#
#_v_________________________v___v_v___v_v_v_v_v_v___v_v_v_v_v_###___v_________________v_____v_______#
#_v_______________________v_________v_v_v_v_v_v_v_v_v_v_v_v_v_#_#_________________________v_______v_#
#_____________________________________v_v_v___v_v_v_v_v_v_v_v_____v___v___________v___v_______v_v___#
#_v_v_____v___________________v_________v_v_v_v_v_v_v_v_v_v_v_v___v_______________________________v_#
v_v_____________________________#################_#_v_v_v_v_v_v_____#############_______v_v_v___v___#
#___v_________________________________v_v_v_v_v_v_v___v_v_v_v_v_v_________________v___v_v___v_v_v___v
#___v___v_______________________________v_v_v_v_____v___v___v_____________________v_____v_____v___v_#
#_________v_________________________________________v_______________________________v___v___v_v_v_v_v
#___v_v_________________v_v_________________________________________v___________v___v_v_v_v_v_v_v_v_v
#_v___v_v_v___v___v_______________________________________________________________v___v_v_v_____v___v
#___v_____v___________v___v_________________________________________v_________v_____v___v___v_v_v_v_#
#___v_____v___v___v_______________v___________________________________________v_v___v___v___v___v_v_#
#___v_v___v___v_______v_____________v_________________________________________v___v___v___v_v___v_v_#
v_#_#_#_#_#_#_#_v_#_#_#_#_#_#_#_v_#_#_#_#_#_#_#_#_#_#_#_#_#_#_#_v_#_#_#_#_#_#_#_#_v_#_#_#_#_#_#_#_#_#
