v_#_#_#_#_#_#_#_v_#_#_#_#_#_#_#_v_#_#_#_#_#_#_#_#_#_#_#_#_#_#_#v#_#_#_#_#_#_#_#_#_v_#_#_#_#_#_#_#_#_#
#_v_v_v___v__v__v__________v______v________________________v___v_v__v_v___________v_________________#
#__v__v_______vv_____v_______v______________________________v____v_______________v__v_______________#
#___v___v_v________________v_____v____________________________v_v__v__________v_____________________#
v_____v_v_v__v______v______v_v________________________________v___v__v____________v__v__v_v_________#
#_v______________v______v___v_________________________________________________________vv__vvv_______#
#_____v_______v___vv_v__v_v_______v_____________________________v________________v_vv__v_v_vvv______#
#_______________vv_v_vv_vv_v____v___v___________________________________v__v__vv___v_vv_v_v______v__#
#____v_____v_vv_vv__vvvv_v__vvv_v_________________________________________________v____v_v_vv_v_____v
#___________v__v_v__v_vvv_v_vvv___v___________________________________v_____v_____v__vv___#__vv_____#
#__v_____v_____v_vvv_v_v_vv_v_vvv_v________________________________________________v______#_v_____v_#
v__________v__v___v_vvvv__v_vv_vv____v___v____________________________#####################_____v___#
#_____v________vv__vv___v__v__vvv_v___________________________________________v__v__vv__v_#_v_______#
#_____v___v_v_v_v__v_v_v_v__vvvv_____v_________________________________________v__v__v____#___v__v__v
v___v__v_v_vv_v_v_v_vvvv_v_vvv__v_v_____________________________________________vv___vvvv_#__v_v____#
v__v____vv____vv_____vv__vv__v_vvv__v_________________________________________________v___#___v_____#
#__vv_vvvvv_vvvv__vv__v__v_v__v__vv________________________________________________v_vvv__v_v_______#
#_____v_vv______v_vv__v_v_v_v__v_________________________________________________________vv_________#
#v_v_vvv_vv_v_v__v___v__vvv__vv_v________v__________________________________________________________#
#_v_vv_v#####################_#_________________________________________________________________v___#
#__v_v_v__v_vv_v____________________________________________________________________________________#
#_v_v_vvvv__vvv__v__________________________________________________________________________________#
#____v_v__v__v__v___v______v____v______________________vv___________________________________________#
#___v_vv__v_vv___v__________v_______________________________________________________________________#
#______v_v_v________________________________________________________________________________________#
#___________v____v_______________________v________v______v__________________________________________#
#____v_________vv___________________________v________________v_____v________________________________#
v__v_________________________________v__v___v_v__v__v______v________________________________________#
#_________________________________________vv_v__v___v_v__v________v_________________________________#
#______________________________v_______v_vvvvv__v_vv__v__vvv__#_#___________________________________#
#_____________________________________vvvv_vvv_v____v_v_vvvvvv#_#___________________________________#
#___________________________v_____v_____vvvvvvv__vv_vvvvv_vvvv#_#____v______________________________#
#______________________________vv_________v_vvv_v_v_vvvvvvvvvv##v_v_________________________________#
#__v____________________________v_____v__vv_v_v_v_v_v_v__vv_v_#_#_________________________v_________#
#__________________________________v_____vv_vv__v_vv__vvv_v_vv#_#v__v_v_____________________________#
#_________________________v_____v_____v__vv_v_v_vvvvv_v_vvv_v_#_#v________v_________________________#
vv____________________________v______v_vv_v_v_v_v_vvv_v_v_v_vv##v_v_v______________________v__v_____#
#_v________________________v____v_v___v_vvvv_vv_v__vvvv_v_vvvv##v___v________________v______v_______#
#_v_______________________v________v__vv_vvvv_vvvvvvvvv_v_v_v_#_#_________________________v______v__#
#____________________________________vv_vvv___vvv_v_v_vvvvvvv____v___v____________v___v_______vv____#
#_v_v____v___________________v__________vvvvv_v_vvv_v_vv_v_vv_v___v_______________________________v_#
vvv_____________________________##################v_v_vvvvvv_vv___v##############_______vv_v____v___#
#__v__________________________________vvvvvvv_v_vvv__v_vvv__vv_v__________________v___v_v___v_v_v__v#
#___v__v_______________________________v_vvv_v_____v____v___v_____________________v____vv_____v___v_#
#________v__________________________________________v_______________________________v___v__vv_vv_v__v
#__v_v__________________v_v________________________________________v____________v___vv_v_vvv_v_v_v__v
#_v___v_vv___v____v_______________________________________________________________v___v_v_v____v___v#
#___v_____v__________v____v________________________________________v_______________v__v_v__v_vvv_vv_#
#__vv_v___v___v__________________v___________________________________________v____v___v___v_v__vvvv_#
#__vv_v___v___v_______v_____________v________________________________________v____v___v___v_v__vvvv_#
v_#_#_#_#_#_#_#_v_#_#_#_#_#_#_#_v_#_#_#_#_#_#_#_#_#_#_#_#_#_#_#v#_#_#_#_#_#_#_#_#_v_#_#_#_#_#_#_#_#_#
                                                                                                      